25 20
#############
#...........#    ########
#...........######......#
#....................d..#
#...........######......#
#...........#    #......#
#...........#    #......#
#...........#    #......#
#####..######    ###..###
    #..#           #..#
    #..#           #..#
    #..#         ###..###
  ###..####      #......#
  #..@....#      #......#
  #.......#      #......#
  #.......#      #......#
  #.......#      #......#
  #.......#      #......#
  #....s..#      #.....!#
  #########      ########
