21 15
######
#.@.s#  #############
#....####...........#
#.......s.#######...#
#########.#######.s.#
        #......##...#
        #.####..##..#
        #.## ##..####
        #..#  ##....#
 #########.########D#
 #................#.#
 #............s...#s#
 #.....s..........#s#
 #................#s#
 ####################